NO textures/wall_no.png
SO textures/wall_so.png 
EA textures/wall_ea.png
WE textures/wall_we.png

F 0,0,255
C 255,255,0


11111111111111111111111111111111
11111111100011100111100000111111
        111110000011100011100011
        100000001111011111111111
11111111000000000000000000000001
11111110000000000000000000000011
111110000000000000001111111000011
111110000000000000000000000001111
1110000000000000000000000000011111
11100000000000000000000000000000001
10000000000000000000000000000000001
10000000000000000000000000000000001
10000000000000000000000000000000001
10000000000000000000000000000000001
10000000000000000000000000000000001
10000000000000000000000000000000001
10000000000000000000000000000000001
11100000000000000000000000000000001
11111111111111110000000000000111111
111110000000000000000N0000000000001
11111111111111111111111111100011111
                          100011111
                          100011111
                          100011111
                          100011111
                          100011111
                          111111111