NO textures/wall_no.png
SO textures/wall_so.png 
EA textures/wall_ea.png
WE textures/wall_we.png

F 40,40,00
C 210,210,210


111111111111111111111111111
111111111111111111111111111
   100000000000000000000001
   1111110000W000111111111
   111111111111111111111111