NO textures/wall_no.png
SO textures/wall_so.png 
EA textures/wall_ea.png
WE textures/wall_we.png

F 40,40,00
C 210,210,210


111111111
100000001
101111011
111000011
111000011
111011111
111000011
111000011
111000001
100000001
111000001
111000011
11000N011
110001111
100011111
100011111
100011111
100011111
100011111
111111111
